nwt	New With Tags
ciao	Goodbye (in Italian)
fawc	For Anyone Who Cares
imjs	I'M Just Saying
mfrc	My Fingers Are Crossed
mws	My Wife Says
swag	Scientific Wild Ass Guess -or- SoftWare And Giveaways
inpo	In No Particular Order
stbx	Soon To Be Ex
tfds	That's For Darn Sure
ttyl	Talk To You Later -or- Type To You Later
swak	Sealed (or Sent) With A Kiss
iitm	It's In The Mail
ttyt	Talk To You Tomorrow
onud	Oh No You Didn't
mhyf	Move How You Feel
iyd	In Your Dreams
fouo	For Official Use Only
figs	French, Italian, German, Spanish
kudt	Dutch for f***ed up life
siup	Suck It Up Pussy
vbmg	Very Big Mischievous Grin
cmf	Count My Fingers
cmb	Call Me Back
l/m	Left Message
fogc	Fear Of Getting Caught
cmu	Crack Me Up
ifab	I Found A Bug
yacc	Yet Another Calendar Company
sobt	Stressed Out Big Time
ayce	All You Can Eat
nev	Neighborhood Electric Vehicle
iyq	I Like You
rlf	Real Life Friend
cula	See You Later Alligator
tntl	Trying Not To Laugh
lgbt	Lesbian, Gay, Bisexual, Transgender
dgtg	Don't Go There Girlfriend
noyb	None Of Your Business
gla	Good Luck All
glb	Good Looking Boy
glg	Good Looking Girl
wdr	With Due Respect
wdt	Who Does That?
aka	or a.k.a. Also Known As
drb	Dirty Rat Bastard
brt	Be Right There
bro	Be Right Over
brl	Belly Roll Laughs
jgmb	Just Google Me B*tch
kmba	Kiss My Black Ass
txt	MSG text message
txs	Thanks
brb	Be Right Back
dnd	Do Not Disturb
lymi	Love You, Mean It
dnc	Does Not Compute
lwr	Launch When Ready
apac	Asia-Pacific
bdsm	Bondage, Dominance, Sadism, Masochism
ysyd	Yeah, Sure You Do
ttys	Talk To You Soon
ltio	Laughing Til I Orgasm
musm	Miss You So Much
musl	Missing You Sh** Loads
ltic	Laughing 'Til I Cry
lore	Learn Once, Repeat Everywhere
jmo	Just My Opinion
mva	w/PI Motor Vehicle Accident with Personal Injury
onid	Oh No I Didn't
md	Doctor of Medicine -or- Managing Director
mf	My Friend
ma	Mature Audience
mb	Message Board
mm	Market Maker -or- Merry Meet
mo	Move On
tnx	Thanks
mt	empty -or- Modified Tweet
tna	Temporarily Not Available
tnc	Tongue In Cheek
ta	Thanks Again
ygm	You've Got Mail
gtsy	Glad To See You
iggp	I Gotta Go Pee
ttfn	Ta Ta For Now
hot	PIC Hot Picture, as in sexy or naked
iiio	Intel Inside, Idiot Outside
ruok	Are You OK?
adip	Another Day In Paradise
lumu	Love You Miss You
lhso	Let's Have Sex Online
gmta	ASDO Great Minds Think Alike, And So Do Ours
ova	it means over
adih	Another Day In Hell
laq	Lame Ass Quote
vfm	Value For Money
wknd	it means weekend
etla	ETLA Extended Three-Letter Acronym (that is, an FLA)
ryfm	Read Your Friendly Manual
wuz	was
fifo	First In, First Out
hbic	Head Bitch In Charge
hbib	Hot But Inappropriate Boy
nsfw	Not Safe For Work
wuf	Where You From
rkba	Right to Keep and Bear Arms
ima	I Might Add
clm	Career Limiting Move
ime	In My Experience
cld	it means cold
imo	In My Opinion
wtgp	Want To Go Private?
icyc	In Case You're Curious -or- In Case You Care
uok	Are You OK?
fofl	Falling on Floor Laughing
fil	Father-In-Law
yttt	You Telling The Truth?
rbtl	Read Between The Lines
yttm	You Talk Too Much
ttul	Talk To You Later
srlb	Spoiled Rotten Little Brat
crbt	Crying Real Big Tears
wtmc	What The Mother C***
suyf	Shut Up You Fool
c%d	it means could
c%l	it means cool
nih	Not Invented Here
mdr	Mort De Rire
osif	Oh Sh** I Forgot
rt	Real Time -or- ReTweet
gol	Giggling Out Loud
goi	Get Over It
gok	God Only Knows
nim	No Internal Message
rx	Regards
gob	Game On B*tcheeez
re	Regards -or- Reply -or- Hello Again
rc	Remote Control
rl	Real Life
rm	Remake
rn	Right Now
smd	Suck My Dick
smb	Suck My Balls
gos	Gay Or Straight
nitl	Not In This Lifetime
fcfs	First Come, First Served
inbd	It's No Big Deal
ntw	Not To Worry
fred	F***ing Ridiculous Electronic Device
tcob	Taking Care Of Business
nth	nothing
ntk	Nice To Know
ntm	Not That Much
ntl	nonetheless
nta	Not This Again
hand	Have a Nice Day
pmsl	Pissed MySelf Laughing
atc	Any Two Cards
angb	Almost Nearly Good Bridge
iss	I Said So -or- I'm So Sure
sahm	Stay At Home Mom
iswc	If Stupid Were a Crime
atm	At The Moment, Asynchronous Transfer Mode, Automated Teller Machine
wrud	What Are You Doing?
atw	All The Web, Around The Web, All The Way, At The Weekend
ish	Insert Sarcasm Here
iso	In Search Of
fupa	Fat Upper Pussy Area
wckd	it means wicked
kfy	-or- K4Y Kiss For You
toy	Thinking Of You
tot	Tons Of Time
tom	Tomorrow
kewl	it means cool
toon	short for cartoon
ntim	Not That It Matters
tgal	Think Globally, Act Locally
ycmu	You Crack Me Up
nofi	No OFfence Intended
raf	Random As F***
lbs	Laughing But Serious
lbr	and LGR Little Boy's Room and Little Girl's Room
lulu	Locally Undesireable Land Use
rat	Remotely Activated Trojan -or- Remote Access Tool
lbh	Let's Be Honest
mins	Minutes
vgn	Vegan -or- Vegetarian
nwr	Not Work Related
doin	it means doing
tyg	There You Go -or- Thank You God
bsf	But Seriously, Folks
qyb	Quit Your Bitching
doc	Drug Of Choice
doa	Dead On Arrival
doe	Depends On Experience
aunt	And U Know This
lylb	Love You Later Bye
lpc	Lead Pipe Cinch
sul	Snooze You Lose
ysan	You're Such A Nerd
cmiw	Correct Me if I'm Wrong
smt	something
ocd	Obsessive Compulsive Disorder
udm	You're the Man
dl	Down Low -or- Download -or- Dead Link
dm	Direct Message
dk	Don't Know
dh	Dear Husband
df	Dear Friend
dd	Due Diligence
da	there
dw	Don't Worry
dp	Domestic Partner
lmao	Laughing My Ass Off
qotd	Quote Of The Day
twss	That's What She Said
bau	Business As Usual
ema	E-Mail Address
eml	Email Me Later
l?^	Let's hook up
bag	Busting A Gut -or- Big Ass Grin
bac	Bad Ass Chick
ftbl	Football
sux	sucks
bak	Back At Keyboard
innw	If Not Now When?
cico	Coffee In, Coffee Out
w/	With
imho	In My Humble Opinion
nub	New person to a site or game
saia	Stupid Asses In Action
iirc	If I Remember Correctly -or- If I Recall Correctly
pyfb	Pay Your F***ing Bill
rmmm	Read My Mail Man
dltm	Don't Lie To Me
wg	Wicked Grin
omb	Oh My Buddha
we	Whatever
omg	Oh My God
wb	Welcome Back -or- Write Back
ome	Oh My Evolution
fiik	F*** If I Know
wk	it means week
rgr	Roger
meh	Who cares, whatever
wtb	Want To Buy
wt	Without Thinking -or- What The -or- Who The
omw	On My Way -or- Oh My Word
wtf	What The F***
wp	Well Played
wth	What The Heck
news	North, East, West, South
wtn	What Then Now? -or- Who Then Now?
wx	Weather
cos	Change Of Subject -or- it means because
unt	Until Next Time
cot	Circle Of Trust
dord	Department Of Redundancy Department
ili	I Love It
fng	F***ing New Guy
ilu	I Love You
cod	Change Of Dressing
unf	Universal Noise of Fucking
pita	Pain In The Ass
col	Chuckle Out Loud -or- Chortling Out Loud
coo	short for cool
ily	I Love You
cuz	Because
bbsl	Be Back Sooner or Later
bbsd	Be Back Soon Darling
wmpl	Wet My Pants Laughing
mcm	Man Crush Monday
lifo	Last In, First Out
kotl	Kiss On The Lips
obtw	Oh By The Way
cuns	See You In School
kotc	Kiss On The Cheek
cunt	See You Next Time -or- Can't Understand Newest Text
gns	GangNam Style
ihnc	I Have No Clue
cul	See You Later
rtbm	Read The Bloody Manual
wfm	Works For Me
slt	Something Like That
prw	Parents Are Watching
ihno	I Have No Opinion
slm	See Last Mail
dkdc	Don't Know Don't Care
aih	As It Happens
rtbs	Reason To Be Single
ij	Inside Joke
im	Instant Messaging -or- Immediate Message
ic	Independant Contractor -or- In Character -or- I See
id	IDentification
bhof	Bald Headed Old Fart
kir	Keep It Real
wycm	Will You Call Me?
kit	Keep In Touch
ayor	At Your Own Risk
kia	Killed In Action
aisb	As I Said Before
aise	As I Said Earlier
thx	or TX or THKS Thanks
aisi	As I See It
nvng	Nothing Ventured, Nothing Gained
om	Old Man
drib	Don't Read If Busy
hak	Hugs And Kisses
hhfo	Hell Has Frozen Over
hay	How Are You?
yoyo	You're On Your Own
mkop	My Kind Of Place
har	Hit And Run
poak	Passed Out At Keyboard
bnf	Big Name Fan
maya	Most Advanced Yet Accessible
rnn	Reply Not Necessary
rny	it means rainy
vim	Very Important Member
snny	it means sunny
bdoa	Brain Dead On Arrival
www	World Wide Web -or- World Wide Wait -or- What Went Wrong
olo	Only Laughed Once
dwym	Does What You Mean
afgo	Another F***ing Growth Opportunity
gypo	Get Your Pants Off
cnp	Continued in Next Post
fos	Full Of Sh**
ykw	You Know What?
fob	the name for a tool, or form of ID
foc	Free of Charge
fol	Fond of Leather
icw	I Can't Wait
plu	People Like Us
pls	Please
plz	Please
plo	Peace, Love, Out
peep	People Engaged and Empowered for Peace
emp	Eat My Pussy
obo	Or Best Offer
plos	Parents Looking Over Shoulder
tayn	Thinking About You Now
obe	Overcome By Events
plur	Peace, Love, Unity, Respect
lhos	Lets Have Online Sex
mbn	Must Be Nice
sob	Son Of a B*tch
soe	Start Of Exams
soh	Sense Of Humor
sok	it's ok
sol	Sh** Out of Luck -or- Sooner Or Later
ppl	People -or- Pay-Per-Lead -or- Pay Per Lead
sos	Same Old Sh** -or- help
sow	Speaking Of Which -or- Statement Of Work
cuol	See You OnLine
lwu	Laughing With You
dewd	dude
wai	What An Idiot
sfb	Sh** For Brains
omdb	Over My Dead Body
wad	Without A Doubt
cwot	Complete Waste Of Time
gic	Gift In Crib
waw	Waiter/Actor/Webmaster -or- What A Whore
was	What A Slut
inmp	It's Not My Problem
yolo	You Only Live Once
oll	OnLine Love
fdff	Falling Down F***ing Funny
ford	Found On Road Dead, Fixed Or Repaired Daily, F***ed Over Rebuilt Dodge
oln	OnLine Netiquette
somf	Sit On My Face
somy	Sick Of Me Yet
rmlb	Read My Lips Baby
wag	Wild Ass Guess -or- Wives And Girlfriends
mtf	More To Follow
kwim	Know What I Mean?
vwp	Very Well Played
shid	Slap Head In Disgust
qix	it means quick
vwd	Very Well Done
elol	Evil Laugh Out Loud
iyam	If You Ask Me
shit	Sugar Honey Ice Tea
nh	Nice Hand
ni	Not Interested
nm	Never Mind -or- Nothing Much -or Not Much -or- Nice Move
no	praw no problem
na	Nice Ass
nb	Nota Bene
nd	No Date
ne	Any
ng	New Game
cyoh	Create Your Own Happening
nr	Nice Roll
ns	Nice Set -or- No Show
tia	Thanks In Advance
nw	No Way
^urs	Up Yours
vcda	Vaya Con Dios, Amigo
pwcb	Person Will Call Back
iyss	If You Say So
dgyf	Damn Girl You're Fine
mpfb	My Personal F*** Buddy
fsr	For Some Reason
fsu	F*** Sh** Up
time	Tears In My Eyes
smem	Send Me E-Mail
gowi	Get On With It
ost	On Second Thought
llt	Looks Like Trouble
milf	Mother I'd Like to F***
ror	Raffing Out Roud (in scooby-doo dialect)
yvw	You're Very Welcome
veg	Very Evil Grin
gigo	Garbage In, Garbage Out
dhyb	Don't Hold Your Breath
lrf	Little Rubber Feet
byki	Before You Know It
bykt	But You Knew That
word	it means cool, a.k.a. word up
hoic	Hold On, I'm Coming
gud	Geographically UnDesirable
jho	Just Helping Out
dic	Drunk In Charge
diy	Do It Yourself
tftc	Thanks For The Cache
pmp	Peeing My Pants
htb	Hang The Bastards
ruh	Are You Horny?
hth	Hope This (or That) Helps
pmbi	Pardon My Butting In
pml	Pissing Myself Laughing
zzz	Sleeping, Bored, Tired
ssia	Subject Says It All
ufn	Until Further Notice
wndy	it means windy
addy	address
bm	Byte Me
nagi	Not A Good Idea
gawd	God
bo	Bug Off -or- Body Odor
gggg	God, God, God, God
stml	Short Term Memory Loss
hbo	Helping a Brother Out
altg	Act Locally, Think Globally
hbb	Hip Beyond Belief
nino	Nothing In, Nothing Out -or- No Input, No Output
bon	Believe it Or Not
hbu	How Bout You?
bob	Battery Operated Boyfriend
bod	Benefit of the Doubt -or- Board Of Directors
love	Lots Of Voluntary Effort
fdgb	Fall Down Go Boom
ipn	I'm Posting Naked
hnti	How Nice That/This Is
hntw	How Nice That Was
fbi	F***ing Brilliant Idea -or- Female Body Inspector
ayk	As You Know
gfon	Good For One Night
ayc	Aren't You Clever -or- Aren't You Cheeky
rut	Are You There?
atwd	Agree That We Disagree
msg	Message
ayv	Are You Vertical?
oof	Out Of Facility
ooc	Out Of Character -or- Out Of Control
advd	Advised
ooo	Out Of Office -or- Out Of Commission
ooi	Out Of Interest
oot	Out Of Touch
oos	Out Of Stock
jad	Just Another Day
ctfu	Cracking The F*** Up
ibk	Idiot Behind Keyboard
cas	Crack A Smile
ctfd	Calm The F*** Down
ctfo	Come The F*** On
ibt	In Between Technology
muah	or MWAH The sound of a kiss
spk	it means speak
?^	Hook up?
wwno	Walker Wheels Need Oil
fpo	For Placement Only
cmap	Cover My Ass Partner
nyc	Not Your Concern
tilf	Teacher I'd Like to F***
aob	Abuse Of Bandwidth
ryo	Roll Your Own
aon	Apropos Of Nothing
atab	Ain't That A Bitch
tbt	Throwback Thursday
aor	Agency On Record -or- Album-Oriented Rock
sfla	Stupid Four Letter Acronym
spoc	Single Point Of Contact
riyl	Recommended If You Like
tbh	To Be Honest
lafw	Listening (but) Away From Window
hsik	How Should I Know
sj	Strong Jaws
sh	Sh** Happens
so	Significant Other
sn	Side Note
sm	Senior Moment
sl	Second Life
sc	Stay Cool
ghm	God Help Me
sf	Surfer Friendly -or- Science Fiction
lsb	Life Sucks Balls
usc	Up Sh** Creek
tts	Text To Speech
ttt	That's The Ticket -or- To The Top -or- Thought That Too
lsv	Language, Sex, Violence
wddd	Woopie Doo Da Dey
tta	Tap That Ass
ttg	Time to Go
hoha	HOllywood HAcker
jic	Just In Case
gtg	Got To Go
gth	Go To Hell
gtk	Good To Know
gtl	Gym, Tan, Laundry
gtm	Giggle To Myself
gts	Google That Sh**
nimq	Not In My Queue
djm	Don't Judge Me
aymm	Are You My Mother
b@u	or BAK@U Back at You
noa	Not Online Anymore
bmoc	Big Man On Campus
noy	Not Online Yet
kkk	it means "over" as in, waiting for your reply
sht	it means so hot
witw	What In The World
shhh	quiet
cqrt	Security
nos	New Old Stock -or- Not Outside Sales
sop	Standard Operating Procedure
tnt	Til Next Time
joml	Jesus On the Main Line
dfla	Disenhanced Four-Letter Acronym (that is, a TLA)
kync	Keep Your Nose Clean
rtfm	Read The F***ing Manual
sot	Short On Time
em	Excuse Me
el	Evil Laugh
ee	or EEs Employee -or- Employees
ed	Erectile Dysfunction
eg	Evil Grin
ez	Easy
wwy	Where Were You?
bplm	Big Person Little Mind
shb	Should Have Been
hcc	Holy Computer Crap
sgtm	Sounds Good To Me
lmp	Lick My Pussy
lms	Like My Status -or- Learning Management System
fwot	F***ing Waste Of Time
lmk	Let Me Know
wak	What A Kiss
xxcc	Kiss, Kiss, Hug, Hug
gafl	Get A F***ing Life
mos	Mom Over Shoulder
nuff	Enough
degt	Don't Even Go There
rtss	Read The Screen Stupid
xoxo	Hugs and Kisses
tftu	Thanks For The Update
rino	Republican In Name Only
rtsm	Read The Silly Manual
lwys	Look What You Started
yic	Yours In Christ
iae	In Any Event
bitd	Back In The Day
iac	In Any Case -or- I Am Confused -or- If Anyone Cares
yiu	Yes, I Understand
fml	F*** My Life
iat	I Am Tired
iaw	I Agree With -or- In Accordance With
hud	How You Doing?
hua	Heads Up Ace -or- Head Up Ass -or- Heard, Understood, Acknowledged
poms	Parent Over My Shoulder
huh	what
alap	As Late As Possible
mtbf	Mean Time Before Failure
pnd	Possibly Not Definitely -or- Personal Navigation Device
j/p	Just Playing
j/w	Just Wondering
slaw	Sounds Like A Winner
emea	Europe, the Middle East, and Africa
slap	Sounds Like A Plan
prt	Partial ReTweet -or- Party
**//	it means wink wink, nudge nudge
j/c	Just Checking
j/j	Just Joking
j/k	Just Kidding
gnoc	Get Naked On Cam
j/o	Jerking Off
taks	That's A Knee Slapper
wcw	Woman Crush Wednesday
imoo	In My Own Opinion
wca	Who Cares Anyway
omfg	Oh My F***ing God
fcs	First Customer Ship
tbyb	Try Before You Buy
mrm	Men's Rights Movement
gidk	Gee I Don't Know
sohf	Sense Of Humor Failure
mra	Moving Right Along
troo	true
tko	Technical Knock Out
ltnt	Long Time, No Type
ltns	Long Time No See
ysic	Why Should I Care?
ddas	Don't Do Anything Stupid
nll	Nice Little Lady
woot	We Own the Other Team
xme	Excuse Me
woof	Well Off Older Folks
ntmu	Nice To Meet You
slom	Sticking Leeches On Myself
fubb	F***ed Up Beyond Belief
ssa	Ass Backwards
ssc	Super Sexy Cute
iuri	If You Are Interested
xqzt	Exquisite
pimp	Peeing In My Pants
ytb	You're The Best
llom	Like Leno on Meth
pwms	playing with myself
rmb	Rings My Bell
ur	you are
dtrt	Do The Right Thing
ambw	All My Best Wishes
wayn	Where Are You Now?
gtrm	Going To Read Mail
wayd	What Are You Doing?
gnsd	Good Night Sweet Dreams
jt	Just Teasing
caac	Cool As A Cucumber
jw	Just Wondering
jp	Just Playing
ibrb	I'll Be Right Back
ywia	You're Welcome In Advance
jk	Just Kidding
jc	Just Curious -or- Just Chilling -or- Jesus Christ
ousu	Oh You Shut Up
jfi	Just For Information
jfh	Just F*** Her
gwi	Get With It
imi	I Mean It
gws	Get Well Soon
twd	Texting While Driving
pov	Point Of View
eadd	Entrepreneurial Attention Deficit Disorder
pos	Parent Over Shoulder -or- Piece Of Sh**
pop	Photo On Profile, Point Of Purchase/Presence, Post Office Protocol
mejr	My Eyes Just Rolled
fttb	For The Time Being
ttmf	Ta Ta MOFO
hbtu	Happy Birthday To You
dyfm	Dude You Fascinate Me
oaus	On An Unrelated Subject
ims	I Am Sorry
lmso	Laughing My Socks Off
fif	F*** I'm Funny
bmf	Bad Mother F***er
gist	Great Ideas for Starting Things
bms	Baby Making Sex
bmw	B*tch, Moan, Whine
ljbf	Let's Just Be Friends
eip	Eggo Is Preggo
s^	what's up?
sex	Sun Users' Group -or- ALL CAPS for sex
hhis	Hanging Head In Shame
soic	So I See
ym	Your Mother
frzn	it means freezing
paw	Parents Are Watching
pax	Passengers
afdn	Any F***ing Day Now
nnr	Need Not Respond
pal	Parents Are Listening -or- Peace And Love
foaf	Friend Of A Friend
foag	F*** Off And Google
foad	F*** Off And Die
oic	Oh, I See
nn	Not Now -or- Need
yhm	You Have Mail
nsb	Not Sure But
gqmf	Gentleman's Quarterly Mother F***er
nc	Nice Crib
gdw	Grin, Duck and Wave
ya	yaya Yet Another Ya-Ya (as in yo-yo)
fumf	Fat Ugly Mother F***er
tobg	This Oughta Be Good
reso	Reservation
gdi	God Damn It -or- God Damn Independent
idky	I Don't Know You
twit	That's What I Thought
swim	See What I Mean?
embm	Early Morning Business Meeting
ditr	Dancing In The Rain
ama	Ask Me Anything
idk,	my BFF Jill I Don't Know, my Best Friend Forever Jill
mop	MOment Please
amf	Adios Mother F***er
awol	Absent Without Leave
moo	Mud Object-Oriented -or- Matter Of Opinion -or- My Opinion Only
unpc	unPolitically Correct
mob	it means mobile
mof	Matter Of Fact
swis	See What I'm Saying
deti	Don't Even Think It
wbu	What 'Bout You?
wbs	Write Back Soon
ynk	You Never Know
stby	Sucks To Be You
gjp	Good Job Partner
sic	Spelling Is Correct
tic	Tongue In Cheek
wttm	Without Thinking Too Much
vrbs	Virtual Reality Bull Sh**
itfa	In The Final Analysis
glbt	Gay, Lesbian, Bisexual, Transgender
tstb	The Sooner, The Better
lmoa	Left a Message On your Answering machine
mooc	Massive Open Online Course
aoyp	Angel On Your Pillow
kma	Kiss My Ass
moos	Member Of The Opposite Sex
cu	See You -or- Cracking Up
kmp	Keep Me Posted
cxo	Chief insert title here Officer
ddg	Drop Dead Gorgeous
nmu	Not Much, You?
nmp	Not My Problem
asap	As Soon As Possible
wtmi	Way Too Much Information
nmh	Not Much Here
oo	Over and Out
ntbn	No Text Back Needed
ol	Old Lady
ok	okay -or- all correct
ace	Access Control Entry
acd	Alt Control Delete
ack	Acknowledgement
of	Old Fart
oc	Original Character -or- Own Character
ob	Obligatory
lpos	Lazy Piece Of Sh**
ot	Off Topic
gtgb	Got To Go Bye
wadr	With All Due Respect
wadi	What A Dumb Idea
dpup	Don't Poop Your Pants
gtgp	Got To Go Pee
lob	Lying On Bed
lok	Lots Of Kisses
lol	WUSS Laugh Out Loud With Unintentional Snort Sound
ymal	You Might Also Like
ymak	You May Already Know
lou	Laughing Over You
pwas	Prayer Wheels Are Spinning
yaf	Young Angry Female
jsyk	Just So You Know
iwsn	I Want Sex Now
cbb	Can't Be Bothered
ab	Ass Backwards -or- Ah Bless
cbf	Can't Be F***ed
cbj	Covered Blow Job
cbm	Covered By Medicare
as	Ape Sh** -or- Another Subject
ar	Action Required
filf	Father I'd Like to F***
ax	it means across
urws	You Are Wise
tsnf	That's So Not Fair
ru	Are You?
tbiu	The Bitch Is Ugly
ftr	For The Record
twhe	The Walls Have Ears
nss	No Sh** Sherlock
ssdd	Same Sh** Different Day
cpg	Consumer Packaged Goods
d/c	disconnected
adad	Another Day Another Dollar
ptl	Praise The Lord
pth	Prime Tanning Hours
alw	Ain't Life Wonderful
t@yl	Talk At You Later
mvto	it means thank you
ptp	Pardon The Pun
imml	I Make Myself Laugh
ty	Thank You
tt	Big Tease
tu	Toes Up (as in dead)
ts	Tough Sh** -or- Totally Stinks
tp	Team Player -or- TelePort -or- Thanks Pal -or- Toilet Paper
to	go nookleer to explode
tm	Trust Me
tk	To Come
tf	Too Funny
wwjd	What Would Jesus Do?
otw	Off The Wall -or- Otherwise
tb	Titty Bar
tc	Take Care
fay	F*** All Y'all
ium	If You Must
fap	F***ing A Pissed
smh	Shaking My Head
fav	Favorite
fah	F***ing A Hot
uwm	You Want Me
fab	Features Attributes Benefits
faf	Find A Friend
sme	Subject Matter Expert
gg	Good Game -or- Gotta Go -or- Giggling
wabi	What A Bright Idea
wsu	What Say You?
t+	it means think positive
scnr	Sorry, Could Not Resist
pbb	Parent Behind Back
sanm	Starting A New Message
bwtm	But Wait, There's More
pbj	Peanut Butter and Jelly -or- Pretty Boy Jock
nbs	No Bull Sh**
idts	I Don't Think So
gn	Good Night
zerg	To gang up on someone
nbg	No Bloody Good
idta	I Did That Already
nbd	No Big Deal
otoh	On The Other Hand
abc	Always Be Creating -or- Collaborating -or- Communicating
sub	Shut Up Bitch
diaf	Die In A Fire
abk	Always Be Knolling
onna	Oh No, Not Again
sup	what's up?
c-t	City
c-p	Sleepy
tcoy	Take Care Of Yourself
ggp	Gotta Go Pee
imco	In My Considered Opinion
ggy	Go Google Yourself
gga	Good Game All
tlgo	The List Goes On
ggn	Gotta Go Now
fwd	Forward
@+	French equivalent of CUL8R
loml	Love Of My Life
fwb	Friends With Benefits
ifu	I F***ed Up
mfic	Mother F***er In Charge
llap	Live Long and Prosper
mmk	mmm ok
vip	Very Important Person
viv	Very Important Visitor
smao	Sweating My Ass Off
dgaf	Don't Give A F***
kmim	Keep Me In Mind
sbug	Small Bald Unaudacious Goal
twu	That's What's Up
morf	Male or Female
mirl	Meet In Real Life
dey	they
jdi	Just Do It
h/o	Hold On
dem	them
h/p	Hold Please
def	Definitely
fsbo	For Sale By Owner
ps	Post Script
wlu	Wicked, Love You
myob	Mind Your Own Business
bffn	Best Friends For Now
hhh	Hip Hip Hooray
pona	Person Of No Account
iono	I Don't Know
csl	Can't Stop Laughing
csn	Chuckle, Snicker, Grin
nwal	Nerd Without A Life
pp	Personal Problem
csa	Cool Sweet Awesome
rys	Read Your Screen
hugz	Hugs
fs	For Sale
gtfo	Get The F*** Out
bka	Better Known As
wytb	Wish You The Best
rbay	Right Back At You
fb	F*** Buddy -or- FaceBook
ofap	Old Fart At Play
fe	Fatal Error
ff	Friends Forever
waef	When All Else Fails
fo	F*** Off
lho	Laughing Head Off
lhm	Lord Have Mercy
lhk	Love Hugs Kisses
lhu	Let's Hook Up
pans	Pretty Awesome New Stuff
itm	In The Money
swl	Screaming With Laughter
atsl	Along The Same Line
fft	Food For Thought
ffs	For F*** Sake
icbw	I Could Be Wrong
ita	I Totally Agree
atst	At The Same Time
its	A D8 It's A Date
ffa	Free For All
xtc	Ecstasy
wtdb	What's The Difference Between
ptmm	Please Tell Me More
wrm	it means warm
wrt	With Regard To -or- With Respect To
wru	where are you?
omwt	On My Way Too
pcm	Please Call Me
good	job Get Out Of Debt job
lmta	Like Minds Think Alike
lmtc	Left a Message To Contact
yb	You B*tch
yf	Wife
foot	F*** Off Over There -or- go away
ys	You Stinker
yr	Yeah Right -or- you -or- your
yw	You're Welcome
iinm	If I'm Not Mistaken
aimp	Always In My Prayers
ygbk	You Gotta Be Kidding
gfy	Good For You -or- Go F*** Yourself -or- Go Find Yourself
jdmj	Just Doing My Job
gfr	Grim File Reaper
fish	First in, Still Here
gwot	Glorified Waste Of Time
gfi	Go For It
gfn	Gone For Now
tafn	That's All For Now
gff	Go F***ing Figure
pwnt	owned
lola	Laugh Out Loud Again
kypo	Keep Your Pants On
ftw	For The Win -or- F*** The World
faql	Frequently Asked Questions List
ftc	Failure To Communicate
fte	Full Time Employee
ftf	F*** That's Funny -or- Face To Face
lolz	Lots Of Laughs
ftl	Faster Than Light
ftn	F*** That Noise
ntb	Not Too Bright
rlco	Real Life Conference
duna	Don't Use No Acronyms
mml	Made Me Laugh
sbi	Sorry 'Bout It
asl	Age/Sex/Location
imru	I Am, Are You?
wtfh	What The F***ing Hell
omik	Open Mouth, Insert Keyboard
fcol	For Crying Out Loud
bhag	Big Hairy Audacious Goal
cupl	Couple
dink	Double Incomes, No Kids
phs	Pointy Haired Stupidvisor
dinr	Dinner
kok	Knock
dfu	Don't F*** Up
esad	Eat Sh** And Die
tfm	Thanks From Me
llta	Lots and Lots of Thunderous Applause
tfh	Thread From Hell
ofc	of course
qls	Reply
tfx	Traffic
tfs	Thanks For Sharing -or- Three Finger Salute
ncg	New College Graduate
dtk	Down To Kill
sta	Short Term Attitude
dtc	Deep Throaty Chuckle
stm	Spank The Monkey
sth	something
aak	Asleep At Keyboard
stw	Search The Web
aas	Alive And Smiling
aar	At Any Rate
kybc	Keep Your Bum Clean
tfn	Thanks For Nothing -or- Til Further Notice
aimb	As I Mentioned Before
wafs	Warm And Fuzzies
bhg	Big Hearted Guy -or- Big Hearted Girl
wafu	What A F*** Up
wafm	What A F***ing Mess
wafb	What A F***ing Bitch
tyvm	Thank You Very Much
lig	Let It Go
lib	Lying In Bed
fyeo	For Your Eyes Only
cofs	Church of Scientology
eft	Electronic Funds Transfer
lir	Let It Rest
lis	Laughing In Silence
buff	Big Ugly Fat F***
kab	Kick Ass Bitch
watn	Where Are They Now
wati	What A Terrible Idea
gilf	Grandmother I'd Like to F***
jsu	Just Shut Up
rhk	RoundHouse Kick
amap	As Many As Possible -or- As Much As Possible
moss	Member(s) Of The Same Sex
wym	What do You Mean?
gbtw	Get Back To Work
kb	Kick Butt
nnww	Nudge, Nudge, Wink, Wink
tpc	The Phone Company
kk	Kiss Kiss -or- OK
sbta	Sorry, Being Thick Again
ko	Knocked Out
ks	Kill Stealer
tpt	Trailor Park Trash
cof$	Church of Scientology
golf	Grateful Of Lovely Family -or- Friends
rtb	Returning To Base
rtm	or RTFM Read The Manual -or- Read The F***ing Manual
rth	Release The Hounds
rtk	Return To Keyboard
ootb	Out Of The Box -or- Out Of The Blue
ootc	Obligatory On Topic Comment
stfu	Shut The F*** Up
rts	Read The Screen
yct	Your Comment To
fine	F***ed up, Insecure, Neurotic, Emotional -or- F*** It Never Ends
jtou	Just Thinking Of You
bfg	Big F***ing Gun
bff	Best Friends Forever -or- Best Friend's Funeral
bfe	Bum F*** Egypt
bfd	Big F***ing Deal -or- Big F***ing Disaster
bfn	Bye For Now
jtol	Just Thinking Out Loud
ief	It's Esther's Fault
std	Seal The Deal, Save The Date, Sexually Transmitted Disease, Stuff To Do
aaf	As A Friend -or- Always And Forever
hig	How's It Going?
hih	Hope It Helps
bofh	Bastard Operator From Hell
rfs	Really F***ing Soon
crs	Can't Remember Sh**
rfp	Request For Proposal
crb	Come Right Back
crd	Caucasian Rhythm Disorder -or- Deficiency
rfd	Request For Discussion
sii	Seriously Impaired Imagination
lmho	Laughing My Head Off
pvp	Player Versus Player
gftd	Gone For The Day
dtf	Down To F***
seg	Sh** Eating Grin
barb	Buy Abroad but Rent in Britain
sec	wait a second
sete	Smiling Ear To Ear
iccl	I Couldn't Care Less
wop	With Out Papers
wom	Word Of Mouth -or- Word Of Mouse
wog	Wise Old Guy
woa	Work Of Art
bibi	Bye Bye
ikr	I Know, Right?
bibo	Beer In, Beer Out
sts	So To Speak
weg	Wicked Evil Grin
mego	My Eyes Glaze Over
pds	Please Don't Shout
alol	Actually Laughing Out Loud
emsg	E-Mail Message
afap	As Far As Possible
wdym	What Do You Mean?
dfik	Darn If I Know
rofl	Rolling On Floor Laughing
imr	I Mean Really
lulz	laughs or LulzSec
wdys	What Did You Say?
msta	Must See To Appreciate
wdyt	What Do You Think?
dui	Driving Under the Influence
c/s	Change of Subject
dum	Do You Masturbate?
chln	it means chilling
tgif	Thank God It's Friday
laoj	Laughing At Own Joke
swf	Single White Female
pb	Potty Break
pc	Personal Computer -or- Politically Correct
pa	Parent Alert
pd	Public Domain
dur	Do You Remember
swu	So What's Up
po	Piss Off
pm	Personal Message -or- Private Message
yllo	You Lie Like Obama
imao	In My Arrogant Opinion
gas	Got A Second?
gap	Got A Pic? -or- Gay Ass People
natc	Not A Text Conversation
gal	Get A Life
gab	Getting A Beer
fuw	F*** You World -or- F*** You Weirdo
lool	Laughing Outrageously Out Loud
mla	Multiple Letter Acronym
bcbg	Bon Chic Bon Genre -or- Belle Cul Belle Geulle
iyo	In Your Opinion
mlm	giving the digital middle finger
bcbs	Big Company, Big School
fud	Fear, Uncertainty, and Disinformation
fub	Fat Ugly Bastard
fum	F***ed Up Mess
motd	Message Of The Day
stys	Speak To You Soon
yati	You're A Total Idiot
bbfn	Bye Bye for Now
hrcn	it means hurricane
aml	All My Love
ddwi	Don't Dick With It
ewi	E-mailing While Intoxicated
glgh	Good Luck and Good Hunting
tqm	Total Quality Management
wuwh	Wish You Were Here
hwga	Here We Go Again
dga	Don't Go Anywhere
syk	So You Know
syl	See You Later
sys	See You Soon
dgt	Don't Go There
syt	See You Tomorrow
byam	Between You And Me
hagd	Have a Great Day
gsw	Gun Shot Wound
hagn	Have A Good Night
hago	Have A Good One
gsc	Gimme Some Credit
huya	Head Up Your Ass
adbb	All Done Bye Bye
ldr	Long Distance Relationship
swit	Sit and Sweat
snag	Sensitive New Age Guy
nwot	New WithOut Tags
bio	Bring It On
bil	Brother-In-Law -or- Boss Is Listening
bif	Basis In Fact -or- Before I Forget
rhip	Rank Has Its Privileges
f/u	it means to Follow Up
itma	It's That Man Again
bseg	Big Sh** Eating Grin
u-l	You Will
tyl	Text You Later -or- Thank You Lord
ijs	I'm Just Saying...
w/o	Without
wip	Work In Process
igtp	I Get The Point
suac	Sh** Up A Creek
pron	porn
pmf	Pardon My French
bd	Big Deal -or- Baby Dance -or- Brain Drain
bf	Boyfriend -or- Best Friend
bg	Be Good
fomo	Fear Of Missing Out
bb	Be Back -or- Buzzard Breath -or- Blessed Be
bc	Because
bl	Belly Laughing
fomc	Fell Off My Chair
bn	Been -or- Being
bi	Business Intelligence
bj	Blow Job
bt	Byte This
bw	Best Wishes
br	Bathroom
bs	Big Smile -or- Bull Sh** -or- Brain Strain
rus	Are You Serious?
gmab	Give Me A Break
bz	Busy
ylw	Your Loving Wife
bgf	Best GirlFriend
yglt	You're Gonna Love This
cmao	Chortling My Ass Off
idm	It Doesn't Matter
idk	I Don't Know
idc	I Don't Care
ylh	Your Loving Husband
idgi	I Don't Get It -or- I Don't Get Involved
bmof	Bite Me Old Fart
nsa	No Strings Attached
btyc	Better Than You Can
btyd	Better Than You Do
lonh	Lights On, Nobody Home
twtr	Twitter
bion	Believe It Or Not
fasb	Fast Ass Son Bitchii
bruf	Big Requirements Up Front
kc	Keep Cool
pwp	Plot, What Plot?
pwn	own
sdk	Scottie Doesn't Know -or- Software Developer's Kit
cid	Consider It Done -or- Crying In Disgrace
uv	Unpleasant Visual
cio	Check It Out -or- Chief Information Officer / Chief Internet Officer
cil	Check In Later
l@u	Laughing At You -or- Laughing About You
sxe	Straight Edge
nbif	No Basis In Fact
lya	Love You All
lyb	Love You Babe
lyl	Love You Lots
nm,	u not much, you?
nab	Not A Blonde
nak	Nursing At Keyboard
b/w	Between
tptb	The Powers That Be
iwfu	I Wanna F*** You
naz	Name, Address, Zip (also means Nasdaq)
tps	That's Pretty Stupid
b/c	Because
nice	Nonsense In Crappy Existence
beos	Nudge
wf	Way Fun
bcoz	because
noob	also seen as: n00b -or- nub -or- no0blet
navy	Never Again Volunteer Yourself
agb	Almost Good Bridge
gt	Good Try
wywh	Wish You Were Here
wd	Well Done
tanj	There Ain't No Justice
edm	Electronic Document Management -or- Electronic Dance Movement
ganb	Getting Another Beer
gf	Girlfriend
gc	Good Crib
gb	Good Bridge
ga	Go Ahead -or- Good Afternoon
gm	Good Morning -or- Good Move
gl	Good Luck -or- Get Lost
gj	Good Job
gi	Google It
yaun	Yet Another Unix Nerd
ugc	User-Generated Content
iyfd	In Your F***ing Dreams
fwiw	For What It's Worth -or- Forgot Where I Was
mlas	My Lips Are Sealed
lfti	Looking Forward To It
aayf	As Always, Your Friend
stfw	Search The F***ing Web
mmyt	Mail Me Your Thoughts
fbks	Failure Between Keyboard and Seat
aeap	As Early As Possible
ufuf	You F***, You Fix
trp	Television Rating Points
hppo	Highest Paid Person in Office
cfv	Call For Vote
rrr	haR haR haR (instead of LOL)
rrq	Return Receipt reQuested
tdm	Too Darn Many
bdc	Big Dumb Company -or- Big Dot Com
bdn	Big Damn Number
fla	Four Letter Acronym
ilmj	I Love My Job
rdv	Reader's Digest Version
vbg	Very Big Grin
vbs	Very Big Smile
nme	Enemy
cta	Call To Action
ctc	Care To Chat -or- Contact -or- Choking The Chicken
aoas	All Of A Sudden
tftt	Thanks For The Thought
cto	Check This Out
dyac	Damn You Auto Correct
jafs	Just A F***ing Salesman
wim	Woe Is Me
wiu	Wrap It Up
wit	Wordsmith In Training
jafo	Just Another F***ing Onlooker
crat	Can't Remember A Thing
cha	Click Here Asshole
crap	Cheap Redundant Assorted Products
bfr	Big F***ing Rock
usp	Unique Selling Proposition
pfa	Pulled From Ass -or- Please Find Attached
iit	Is It Tight?
pfc	Pretty F***ing Cold
iir	If I Remember -or- If I Recall
ttth	Talk To The Hand
pfm	Pure F***ing Magic
nmte	Now More Than Ever
sorg	Straight or Gay
tttt	To Tell The Truth
baby	Being Annoyed By You
taf	That's All, Folks
og	Original Gangsta
taw	Teachers Are Watching
tap	Take A Pill
tas	Taking A Shower
sro	Standing Room Only
bcnu	Be Seeing You
jhom	Just Helping out My (Mafia, Mob, Neighbors, etc.)
tam	Thanks A Million
tah	Take A Hike
dws	Driving While Stupid
sip	Skiing In Powder
afk	Away From Keyboard -or- A Free Kill
siy	Search Inside Yourself
afc	Away From Computer
dwb	Don't Write Back
sia	Say It Again
afz	Acronym Free Zone
aft	About F***ing Time
afu	All F***ed Up
dwh	During Work Hours
afw	Away From Window
oz	Australia
imgc	I Might Get Caught
fitb	Fill In The Blanks
zmg	or ZOMG Oh My God
btfo	Back The F*** Off -or- Bend The F*** Over
bndn	Been Nowhere Done Nothing
sry	it means sorry
afj	April Fools Joke
sit	Stay In Touch
a/n	Author's Note
kbd	Keyboard
obx	Old Battle Axe
posc	Piece Of Sh** Computer
wawi	What A Wonderful Idea
lf	Let's F***
lg	Life's Good -or- Long Gone
ld	Long Distance -or- Later Dude
tsh	Too Stinkin' Hot
lo	it means hello
ll	Livin' Large
tsb	Tall, Sexy, Beautiful
lh	Laughing Hysterically
kmuf	Kiss Me You Fool
msmd	Monkey See Monkey Do
lbug	or LBIG Laughing Because You're Gay -or- Laughing Because I'm Gay
tsr	Totally Stuck in RAM -or- Totally Stupid Rules
ly	Love You
rfr	Really F***ing Rich
kiss	Keep It Simple Stupid
wyfm	Would You F*** Me?
kcco	Keep Calm &amp; Carry On
ibtc	Itty Bitty Titty Committee
diku	Do I Know You?
nadt	Not A Damn Thing
nfg	Not F***ing Good
nff	No F***ing Fair
nfe	No F***ing Excuses
dwi	Driving While Intoxicated
nfc	Not Favorably Considered -or- No F***ing Chance
tram	The Rest Are Mine
tisl	This Is So Lame
nfi	No F***ing Idea
sin	Stop It Now
nfw	No F***ing Way -or- No Feasible Way
kpc	Keeping Parents Clueless
nfs	Need For Sex -or- Network File System
bttt	Back To The Top -or- Bump To The Top
sil	Sister-In-Law
hpoa	Hot Piece Of Ass
n/m	Nothing Much
bump	Bring Up My Post
emi	Excuse My Ignorance
n/a	Not Applicable -or- Not Affiliated
lfu	Life"s F***ed Up
n/t	No Text
pbem	Play By EMail
ggoh	Gotta Get Out of Here
smop	Small Matter of Programming
aatk	Always At The Keyboard
snl	Same Night Lay
p-za	Pizza
w/e	Weekend
bwi	But What If
bwl	Bursting With Laughter
bwo	Black, White or Other
lts	Laughing to Self
ltr	Long Term Relationship
sthu	Shut The Hell Up
hhos	Ha Ha, Only Serious
hhok	Ha Ha, Only Kidding
hhoj	Ha Ha, Only Joking
ltf	Lick The Floor
ltm	Laughing To Myself
ihy	I Heart You -or- I Hate You
wts	Want To Sell
bamf	Bad Ass Mother F***er
ihu	I Hear You
iha	I Hate Acronyms
ugtr	You Got That Right
sep	Somebody Else's Problem
pots	Plain Old Telephone System -or- Pat On The Shoulder
soi	Self Owning Idiot
rsn	Real Soon Now
cyt	See You Tomorrow
cya	Cover Your Ass -or- See Ya
cye	Check your Email
gsoh	Good Sense Of Humor
cyo	See You Online
cym	Check Your Mail
cyl	See You Later
yby	Yeah Baby Yeah
khyf	Know How You Feel
ybs	You'll Be Sorry
beg	Big Evil Grin
sed	Said Enough Darling
pmji	Pardon My Jumping In
ybf	You've Been F***ed
\m/	Heavy Metal Music
neet	Not currently Engaged in Employment, Education, or Training
eak	Eating at Keyboard
nqa	No Questions Asked
su	Shut Up
mih	Make It Happen
mil	Mother-In-Law
mia	Missing In Action
istm	It Seems To Me
istr	I Seem To Remember
qt	Cutie -or- Quiet
omma	Oh My Aching Ass
sfx	Sound Effects -or- Stage Effects
sfp	Sorry For Partying
xlnt	Excellent
sb	Stand By
*$	Starbucks
awc	After While, Crocodile
urw	You Are Welcome
wot	Waste Of Time or- it means what
ooak	One Of A Kind
tdtm	Talk Dirty To Me
urz	yours
dba	Doing Business As
esmf	Eat Sh** Mother F***er
dbd	Don't Be Dumb
wyrn	What's Your Real Name?
nagb	Nearly Almost A Good Bridge
tsra	Two Shakes of a Rat's Ass
kity	Keep It To Yourself
fear	Forget Everything And Run -or- Face Everything And Recover
wotd	Word Of The Day
ngb	Nearly Good Bridge
rmma	Reading My Mind Again
ngh	Not Gonna Happen
jas	Just A Second
jam	Just A Minute
irl	In Real Life
idst	I Didn't Say That
w@	What?
tbu	Thinking 'Bout You
kyfc	Keep Your Fingers Crossed
sdfb	Smoke Dope F*** B*tches
ydkm	You Don't Know Me
tba	To Be Advised
tbc	To Be Continued
ymmv	Your Mileage May Vary
tbe	Thick Between Ears
tbd	To Be Determined
qq	Quick Question -or- Cry More
gbg	Great Big Grin
qs	Quit Scrolling
dps	Damage Per Second
kibo	Knowledge In, Bullsh** Out
nism	Need I Say More
gras	Generally Recognized As Safe
gbh	Great Big Hug
qc	Quality Control
rtfq	Read The F***ing Question
bbbg	Bye Bye Be Good
ql	Quit Laughing
btw	By The Way -or- Bring The Wheelchair
btr	Better
rafo	Read And Find Out
btd	Bored To Death
bta	But Then Again -or- Before The Attacks
shtf	Sh** Hits The Fan
wc	Who Cares -or- Water Closet
btn	Better Than Nothing
luv	it means love
ymmd	You Make My Day -or- You Made My Day
luk	it means good luck
p/u	Pick Up
utm	You Tell Me
joy	Jesus first, Others second, Yourself last
oml	Oh My Lord
qft	Quoted For Truth -or- Quit F***ing Talking
etx	End of TeXt
wu	What's Up
tlc	Tender Loving Care
nnsh	night night sweet heart
tla	Three Letter Acronym
eta	Estimated Time of Arrival -or- Edited To Add
cn	Can
cm	Call Me
cc	carbon copy
cb	Chat Brat -or- Coffee Break -or Call Back
wtg	Way To Go
iaym	I Am Your Master
cf	Coffee Freak -or- Cluster F***
cy	Calm Yourself
cx	Cancelled
rpg	Role Playing Games
cs	Career Suicide
ctmq	Chuckle To Myself Quietly
ct	Can't Talk -or- Can't Text
bbl	Be Back Later
nimy	Never In A Million Years
bbb	Bye Bye Babe -or- Boring Beyond Belief
ai	Artificial Intelligence -or- As If
nhoh	Never Heard Of Him/Her
bbw	Big Beautiful Woman -or- Big Black Woman
bbt	Be Back Tomorrow
bbs	Be Back Soon -or Bulletin Board Service
bbr	Burnt Beyond Repair
bbq	Bar-B-Que -or- Barbeque
oth	Off The Hook
otl	Out To Lunch
hmu	Hit Me Up
otc	Over The Counter
otf	On The Floor -or- On The Fone
myt	Meet You There
otp	On The Phone
otr	On The Road
ots	On The Scene -or- On The Spot -or- Off The Shelf
ott	Over The Top
botl	Bra On The Loose
ysk	You Should Know
ap	Apple Pie
soz	Sorry
rbu	Rainbows, Butterflies, Unicorns
ila	I Love Acronyms
rsvp	Repondez S'il Vous Plait
wilb	Workplace Internet Leisure Browsing
vc	Venture Capital
lusm	Love You So Much
sitd	Still In The Dark
vm	Voice Mail
pso	Product Superior to Operator
pdq	Pretty Darn Quick
fkm	F*** 'Em
tfys	The F*** You Say
cob	Close Of Business
dusl	Do You Scream Loud?
upod	Under Promise Over Deliver
iow	In Other Words
phb	Pointy Haired Boss
iou	I Owe You
iot	In Order To
ion	Index Of Names
ioh	I'm Outta Here
dust	Did You See That?
igws	It Goes Without Saying
wyw	Wish You Well
mrph	Mail the Right Place for Help
wyt	Whatever You Think
wys	Whatever You Say
wyp	What's Your Problem?
phat	Pretty Hot And Tempting
wyd	What You Doing?
pda	Personal Digital Assistant -or- Public Display of Affection
mtla	My True Love Always
ioud	Inside, Outside, Upside Down
ibtl	In Before The Lock
mfd	Multi-Function Device
mhhm	uh huh -or- yeah
mfg	Mit freundlichen Gruessen
sufi	Super Finger -or- Shut Up F***ing Imbecile
rgds	it means regards
tcb	Trouble Came Back -or- Taking Care of Business
adr	Address
sicl	Sitting In Chair Laughing
ibtd	I Beg To Differ
add	Address
nato	No Action, Talk Only
adn	Advanced Digital Network -or- Any Day Now
adm	Aye Dios Mio
rehi	Hi Again
fyc	For Your Consideration
psa	Public Service Announcement
fya	For Your Amusement
fyf	From Your Friend
btdt	Been There Done That
fye	For Your Edification
fyi	For Your Information
fatm	Foaming At The Mouth
fym	For Your Misinformation
tisc	This Is So Cool
dese	these
nvm	NeVer Mind
rtff	Read The F***ing FAQ
mstm	Makes Sense To Me
iiwm	If It Were Me
rotm	Right On The Money
vsf	Very Sad Face
doei	Goodbye (in Dutch)
wwsd	What Would Satan Do?
esg	Environmental, Social, Governance
tma	Too Many Acronyms
eso	Equipment Smarter than Operator
tmi	Too Much Information
kmwa	Kiss My White Ass
esh	Experience, Strength, and Hope
cwyl	Chat With You Later
grrr	Growling
w's^	what's up?
c/p	Cross Post
aitr	Adult In The Room
nidl	Not Interested, DisLike
yaba	Yet Another Bloody Acronym
np	No Problem -or- Nosy Parents
pw	password
idrk	I Don't Really Know
ndn	Indian
pu	That Stinks
mofo	Mother F***er
tsob	Tough Son Of a B*tch
merp	Modestly Enlightened Rich People
tsia	This Says It All
tsif	Thank Science It's Friday
bsod	Blue Screen of Death
waci	What A Cool Idea
stst	Sweet Tea SweeTie
rci	Rectal Cranial Inversion
smim	Send Me an Instant Message
ux	User eXperience
hx	it means history -or- hospital
hp	Higher Power
hv	Have
ht	Hi There -or- Hat Tip
hu	Hook Up
hi	5 High Five
ho	Hang On -or- Hold On
hb	Hurry Back
hf	Hello Friend -or- Have Fun -or- Have Faith
hd	Hold
byow	Build Your Own Website -or- Bring Your Own Wine
dmi	Don't Mention It
byob	Bring Your Own Bottle -or- Bring Your Own Beer
wisp	Winning Is So Pleasureable
byoa	Bring Your Own Advil
byod	Bring Your Own Device
ftrf	F*** That's Really Funny
pin	Person In Need -or- Personal Identification Number
pif	Paid In Full
pix	pictures -or- photos
myl	Mind Your Language
pir	Parent In Room
durs	Damn You Are Sexy
nrn	No Reply Necessary
oao	Over And Out
sics	Sitting In Chair Snickering
book	it means cool
dwbh	Don't Worry Be Happy
ubs	Unique Buying State
nrg	Energy
dyli	Do You Love It?
eod	End Of Day -or- End Of Discussion
eom	End Of Message
eol	End Of Life
eot	End Of Thread/Text/Transmission
hny	Happy New Year
snif	Simple Nice Index File
